000002222200000
000000000000000
802222000022200
802111111111200
802222000022200
000000000000000
000000000000000
222222222222222