111100000011111111111111
111000000001111111111111
110000000000111111111111
110000100000011111111111
110000111000000111111111
110000001100000012222221
111000801100000022000021
111008001100000000000021
111000801111000000000021
111999991111111111000021
111000000000000000000021
111100000000000000000021
111100000000000000000021