111100001111111111111111
111000000111111111111111
110000000001111111111111
110001100000111111111111
110000111000001111111111
110000001100000112222221
111100801100000111000021
111108001100000000000021
111100801111000000000021
111199911111111111100021
111100001111000000200021
111110000000000000000021
111111000000011110000011