11100000001111100000011
11000000000000000000011
11000000000000000000011
11000000000000000000011
10888002222000022200001
19999211111111120000001
10000002222000022200001
10000000000011000000001
11000000000000000000011
11000000000000000000011
11000000000000000000011
11000000000000000000011
11111111111111111111111